17 17
#################
#...............#
#...............#
#...............#
#...............#
#...............#
#...............#
#...............#
#.......P.......#
#...............#
#...............#
#...............#
#...............#
#...............#
#...............#
#...............#
#################

IF YOU WANT TO CHANGE THE MAP, PLEASE MAKE IT AT LEAST 2 BLOCK WIDE FOR PREVENT UNEXPECTED ERROR